xxxxxxxxxxxxxxxxxxxx
x                  x
x         S        x
x   d  x     x d   x
x       xxxxx      x
xxx  dddddd   x  xxx
x                  x
x   d   xxxx   d   x
x                  x
x   d    dddddd    x
xxx    xxxxxx    xxx
x     x      x     x
x        s         x
x                  x
xxxxxxxxxxxxxxxxxxxx