xxxxxxxxxxxxxxxxxxxx
x                  x
x         S        x
x                  x
x        xxx       x
xxx  dddddd      xxx
x                  x
x   d   xxxx   d   x
x                  x
x   d    dddddd    x
xxx     xxx      xxx
x                  x
x        s         x
x                  x
xxxxxxxxxxxxxxxxxxxx