xxxxxxxxxxxxxxxxxxxx
x         S        x
x                  x
x                  x
x                  x
x    dddddd        x
x                  x
x                  x
x                  x
x        dddddd    x
x                  x
x                  x
x            s     x
x                  x
xxxxxxxxxxxxxxxxxxxx