xxxxxxxxxxxxxxxxxxxx
x                  x
x         S        x
x                  x
x                  x
x    dddddd        x
x                  x
x       xxxx       x
x                  x
x        dddddd    x
x                  x
x                  x
x        s         x
x                  x
xxxxxxxxxxxxxxxxxxxx